NO ./textures/wall.png
SO ./textures/wall.png
WE ./textures/wall.png
EA ./textures/wall.png



F 0,0,0
C 255,0,0

      
        1111111111111111111111111
        1000000000110000000000001
        1011000001110000000000001
        1001000000000000000000N01
        1111111111111111111111111

     